111111111111
100000E00001
100000000001
100000000001
100000000P01
100000000001
111111111111