111111111111111
100000000000001
110000011100001
100000000000001
110011111111101
100000000000001
110000000000001
111111111111111