11111111111111111111111111111111111111111111
10000000000000000000000000000000000000000001
10000000P00000000000000000000000000000000001
1000000000000000000000000000000000000000C001
10000000000000000000000000000000000000000001
1000000000E00000000000000000000000000000000000000000000000000000000000000000000000000000000000000000000000000000000000000000000001
1000000000000000000000000000000000000000C001123
11111111111111111111111111111111111111111111