11111111111111111111
10000000000000011111
10000000000011111111
1000000000001E111111
10000000000010000001
10000001000010000001
101000001001C00P1001
10100000101011110001
10100000101000001001
10100000001000001001
11111111111111111111

11111111111111111111
