11111111111111111111111111111111
10000000000000000000000000000001
10000000000000000000000000000001
10000000000000000000000000000001
10000000000000000000000000000001
10000000000000000000000000000001
10000000000000000000000001E11111
10000000000000000000000001000CE1
10000000000000000000000001000P01
10000000000000000000000001000001
11111111111111111111111111111111