111111111
1000000E1
100sdas01
10P000001
10000C001
111111111



dadadasdas