111111111111111111111111
100000000000000000000001
100000000000000000000001
10000000000E000000000001
10000000000000000C000001
100000000000000000000001
100000000000000000000P01
111111111111111111111111

dsfdsfsfsd